{
	"textures": [
		{
			"_name": "cobblestone_material",
			"type": "NORMAL",
			"path": "assets/textures/cobblestone.png"
		},
		{
			"type": "ANIMATED",
			"step_count": [ 1, 17 ],
			"spacer": [ 0, 0 ],
			"step_size": [ 256, 256 ],
			"delay": 20,
			"path": "assets/textures/water.png"
		},
		{
			"_name": "adolf",
			"type": "NORMAL",
			"path": "assets/textures/adolf.png"
		},
		{
			"_name": "jesu",
			"type": "NORMAL",
			"path": "assets/textures/test.png"
		},
		{
			"_name": "jesu",
			"type": "NORMAL",
			"path": "assets/textures/walls.png"
		}
	],
	"blocks": [
		{
			"_name": "cobblestone",
			"type": "NORMAL",
			"height": 2,
			"minimap_color": [ 255, 255, 0 ],
			"sides": {
				"ALL": {
					"color": [ 255, 0, 0 ],
					"texture": 0
				}
			}
		},
		{
			"_name": "adolf",
			"type": "NORMAL",
			"minimap_color": [ 255, 0, 0 ],
			"sides": {
				"ALL": {
					"color": [ 255, 255, 0 ],
					"texture": 0
				},
				"EAST": {
					"color": [ 255, 0, 0 ],
					"texture": 1
				}
			}
		},
		{
			"type": "NORMAL",
			"minimap_color": [ 255, 25, 255 ],
			"height": 0.2,
			"sides": {
				"ALL": {
					"color": [ 255, 255, 0 ],
					"texture": 1
				},
				"NORTH": {
					"color": [ 255, 0, 0 ],
					"texture": 3
				}
			}
		},
		{
			"type": "ROUND",
			"minimap_color": [ 255, 0, 0 ],
			"texture": 1
		},
		{
			"type": "ROUND",
			"minimap_color": [ 255, 0, 0 ],
			"radius": 0.2,
			"texture": 2
		},
		{
			"type": "ROUND",
			"minimap_color": [ 255, 0, 0 ],
			"radius": 0.02,
			"texture": 1
		}
	],
	"map": {
		"size": [ 24, 24, 2 ],
		"floor_texture": 3,
		"ceil_texture": 2,
		"data": [
			[1, 1, 1, 1, 1, 1, 1, 1, 1, 1, 1, 1, 1, 1, 1, 1, 1, 1, 1, 1, 1, 1, 1, 1],
			[1, 0, 0, 0, 0, 0, 0, 0, 0, 0, 0, 0, 0, 0, 0, 0, 0, 0, 0, 0, 0, 0, 0, 1],
			[1, 0, 0, 0, 0, 0, 0, 0, 0, 0, 0, 0, 0, 0, 0, 0, 0, 0, 0, 0, 0, 0, 0, 1],
			[1, 0, 0, 0, 0, 0, 0, 0, 0, 0, 0, 0, 0, 0, 0, 0, 0, 0, 0, 0, 0, 0, 0, 1],
			[1, 0, 0, 0, 0, 0, 0, 0, 0, 0, 0, 0, 0, 0, 0, 0, 0, 0, 0, 0, 0, 0, 0, 1],
			[1, 0, 0, 3, 3, 0, 0, 0, 0, 0, 0, 0, 0, 0, 0, 0, 0, 0, 0, 0, 0, 0, 0, 1],
			[1, 0, 0, 3, 3, 0, 0, 0, 0, 0, 0, 0, 0, 0, 0, 0, 0, 0, 0, 0, 0, 0, 0, 1],
			[1, 0, 0, 3, 0, 0, 0, 0, 2, 2, 2, 2, 2, 0, 0, 0, 0, 0, 0, 0, 0, 0, 0, 1],
			[1, 0, 0, 3, 0, 0, 0, 0, 2, 0, 0, 0, 2, 0, 0, 0, 0, 0, 0, 0, 0, 0, 0, 1],
			[1, 0, 0, 3, 0, 0, 0, 0, 2, 0, 0, 0, 2, 0, 0, 0, 0, 0, 0, 0, 0, 0, 0, 1],
			[1, 0, 0, 2, 0, 0, 0, 0, 2, 0, 0, 0, 2, 0, 0, 0, 0, 0, 0, 0, 0, 0, 0, 1],
			[1, 0, 0, 2, 0, 0, 0, 0, 2, 2, 2, 0, 2, 0, 0, 0, 0, 0, 0, 0, 0, 0, 0, 1],
			[1, 0, 0, 2, 0, 0, 0, 0, 0, 0, 0, 0, 0, 0, 0, 0, 0, 0, 2, 0, 0, 0, 0, 1],
			[1, 0, 0, 0, 0, 0, 0, 0, 0, 0, 0, 0, 0, 0, 0, 0, 0, 0, 0, 0, 0, 0, 0, 1],
			[1, 0, 0, 0, 0, 0, 0, 0, 0, 0, 0, 4, 0, 0, 0, 0, 0, 0, 0, 0, 0, 0, 0, 1],
			[1, 0, 0, 0, 0, 1, 2, 0, 0, 0, 0, 0, 0, 0, 0, 0, 0, 0, 0, 0, 0, 0, 0, 1],
			[1, 0, 0, 0, 0, 0, 0, 0, 0, 5, 0, 6, 0, 0, 0, 0, 0, 0, 0, 0, 0, 0, 0, 1],
			[1, 0, 0, 0, 0, 0, 0, 0, 0, 0, 0, 0, 0, 0, 0, 0, 0, 0, 0, 0, 0, 0, 0, 1],
			[1, 0, 0, 0, 0, 0, 0, 0, 0, 0, 0, 0, 0, 0, 0, 0, 0, 0, 0, 0, 0, 0, 0, 1],
			[1, 0, 0, 0, 0, 0, 0, 0, 0, 0, 0, 0, 0, 0, 0, 0, 0, 0, 0, 0, 0, 0, 0, 1],
			[1, 0, 0, 0, 0, 0, 2, 2, 2, 2, 2, 2, 0, 0, 0, 0, 0, 0, 0, 0, 0, 0, 0, 1],
			[1, 0, 0, 0, 0, 0, 0, 0, 0, 0, 0, 0, 0, 0, 0, 0, 0, 0, 0, 0, 0, 0, 0, 1],
			[1, 0, 0, 0, 0, 0, 0, 0, 0, 0, 0, 0, 0, 0, 0, 0, 0, 0, 0, 0, 0, 0, 0, 1],
			[1, 1, 1, 1, 1, 1, 1, 1, 1, 1, 1, 1, 1, 1, 1, 1, 1, 1, 1, 1, 1, 1, 1, 1]
		]
	}
}
